##############
#            #
#  0         #
#            #
#      x     #
#            #
#    #       #
#            #
##############