##############
#            #
#  o         #
#            #
#      x     #
#            #
#    #       #
#            #
##############